                                                   
                                                   
                 .......                           
                 .......               ........    
                 .......               ........    
      ......     ..............................    
      ............    .                ........    
      ......     .    .                ........    
      ..................................    .      
      ......    ..... .                .    .      
        .       ..... .                .    .      
        .       ..... .                .    .      
        .       ..... .                .  .......  
        .       ..... .                .  .......  
        .       ..... .                .  .......  
        .       .......                .  .......  
        .       .    ..                .  .......  
        .       .    ........          .  .......  
        .       .    ........          .  .......  
        .       .    ......................        
        .       .    ........          .  .        
        .       .    ........          .  .        
        .       .    ........          .  .        
        .       .    ..                .  .        
   .......      .    ..                .  .        
   .......   .....   ....              .  .        
   .......   .....   ....              .  .        
   .......   .....   ...................  .        
   ......................       .......   .        
   ........  .       ....       .......   .        
        . .  .       ....       .......   .        
        . .  .       ............     ..........   
        . .  .       ....       .         ......   
        . .  .          .       .         ......   
        . ......        .   .....         ......   
        . ......     .....  ....          ......   
        . ................  ....          ......   
        . ......     .....  ....          .        
        . ......     .....  ....      .....        
     .... ......     .....  ....      ....         
     ...........     .....................         
     .... ......     .....            ....         
     ....                             ....         
     ....                             ....         
     ....                             ....         
                                      ....         
                                                   
                                                   
                                                   
                                                   
                                                   
